stage
26,26,26,26,26,26,26,26,26,26,26,26,26,26,26,26,26,26,26,26,26,26,26,26,26,26
26,26,26,26,26,26,26,26,26,26,26,26,26,26,26,26,26,26,26,26,26,26,26,26,26,26
26,26,26,26,26,26,26,26,26,26,26,26,26,26,26,26,26,26,26,26,26,26,26,26,26,26
26,26,26,26,26,26,25,25,25,25,25,25,25,25,25,25,25,0,1,25,26,26,26,26,26,26
26,26,26,26,26,26,25,25,25,25,25,25,25,25,25,25,25,25,25,25,26,26,26,26,26,26
26,26,26,26,26,26,25,25,25,25,25,25,1,25,25,25,25,25,25,25,26,26,26,26,26,26
26,26,26,26,26,26,25,25,25,25,25,25,25,25,25,25,25,25,25,4,26,26,26,26,26,26
26,26,26,26,26,26,25,0,25,25,25,25,25,25,25,4,25,25,25,25,26,26,26,26,26,26
26,26,26,26,26,26,25,25,25,25,25,25,25,25,25,25,25,25,25,25,26,26,26,26,26,26
26,26,26,26,26,26,25,25,25,25,25,25,25,1,25,25,25,25,25,0,26,26,26,26,26,26
26,26,26,26,26,26,25,25,25,25,25,25,25,25,25,25,25,25,25,25,26,26,26,26,26,26
26,26,26,26,26,26,25,25,25,25,25,25,25,25,25,25,25,25,25,25,26,26,26,26,26,26
26,26,26,26,26,26,25,25,25,25,25,25,25,25,25,25,25,25,25,25,26,26,26,26,26,26
26,26,26,26,26,26,25,25,25,25,25,25,25,25,25,25,25,2,25,26,26,26,26,26,26
26,26,26,26,26,26,25,25,25,25,25,11,12,25,25,1,25,25,25,26,26,26,26,26,26
26,26,26,26,26,26,26,26,26,26,26,26,26,26,26,26,26,26,26,26,26,26,26,26,26,26
26,26,26,26,26,26,26,26,26,26,26,26,26,26,26,26,26,26,26,26,26,26,26,26,26,26
26,26,26,26,26,26,26,26,26,26,26,26,26,26,26,26,26,26,26,26,26,26,26,26,26,26